1111111111111
10010C00000C1
1000011111001
1011001000011
1011000001001
1P0011E0000C1
1111111111111