111111111111111111111111111111111111111
100000000000000000000000000000000000001
101110011001001011101000100110011000101
101010100101010010001101101001010100101
101110100101100011101010101001010010101
101000100101010010001000101001010001101
101000011001001011101000100110010000101
1P0000000000C000000E0000000000000000001
111111111111111111111111111111111111111