111111111243111111111
1P0000100000100000C01
101110101110101111101
101C00100010001010001
101111111011101C10111
10001000100C100010101
11101C111010111110101
100000100010001000C01
101111101011111011111
100000001C001000C00E1
111111111111111111111